NO ./assets/textures/wall1.xpm
SO ./assets/textures/wall2.xpm
WE ./assets/textures/wall3.xpm
EA ./assets/textures/wall4.xpm

DO ./assets/textures/door.xpm

F ./assets/textures/ground.xpm
C ./assets/textures/sky.xpm

        1111111111111111111111111
        1000000000110000000000001
        101100000111000000011D111
        1001000000D00G00000000001
11111111101100000111000000000N001
10000000001100000111D111111111111
11110111111111011100000010001
11110111111111011101010010001
11110111111111111111D11111111
11000000110101011100000010001
1000GG00000000001100000010001
1000000G0000G000D001010010001
1100000111010101111101111000111
11110111 1110101 101111010001
11111111 1111111 111111111111
