NO ./assets/textures/wall1.xpm
SO ./assets/textures/wall2.xpm
WE ./assets/textures/wall3.xpm
EA ./assets/textures/wall4.xpm

F 71,62,55
C 216,227,231

1111111
1NG0001
1011111
1GG0001
1000001
1111111