NO ./assets/textures/north_wall.xpm
SO ./assets/textures/south_wall.xpm
WE ./assets/textures/west_wall.xpm
EA ./assets/textures/east_wall.xpm

F 64,64,64
C 135,206,235

11111111111111111111111111111111111111111111111
10000000000000000000000000000000000000000000001
10110000011100000111000001110000011100000111001
10100000010100000101000001010000010100000101001
10100000010100000101000001010000010100000101001
10110000011100000111000001110000011100000111001
10000000000000000000000000000000000000000000001
10111111011111110111111101111111011111110111101
10100001010000010100000101000001010000010100001
10100001010000010100000101000001010000010100001
10100001010000010100000101000001010000010100001
10111111011111110111111101111111011111110111101
10000000000000000000000000000000000000000000001
10111111011111110111111101111111011111110111101
10100001010000010100000101000001010000010100001
10100001010000010100000101000001010000010100001
10100001010000010100000101000001010000010100001
10111111011111110111111101111111011111110111101
10000000000000000000000000000000000000000000001
10110000011100000111000001110000011100000111001
10100000010100000101000001010000010100000101001
10100000010100000101000001010000010100000101001
10110000011100000111000001110000011100000111001
10000000000000000000000000000000000000000000001
10000000000000000000000000000000000000000000001
10000000000000000000000000000000000000000000001
10000000000000000000000N00000000000000000000001
10000000000000000000000000000000000000000000001
10000000000000000000000000000000000000000000001
10000000000000000000000000000000000000000000001
11111111111111111111111111111111111111111111111