NO ./assets/textures/wall1.xpm
SO ./assets/textures/wall2.xpm
WE ./assets/textures/wall3.xpm
EA ./assets/textures/wall4.xpm 

F 71,62,55
C 216,227,231

            111
        111111111111111111111111
        10000011 1110000000000001
        10110001 1110000000000001
        10010001 1000000000000001
1111111110110001 111000000001N101
100000000110001 1110111111111111
1111011111111101 100000010001
11110111111111011101010010001
11110111111111111111111111111
11000000110101011100000010001
10000000000000011100000010001
10000000000000011101010010001
11111111111111111111111111111
11110111 10111011110100011111
11111111 11111111111111111111111111111111111
1
1
1
1
1
1
1
1
1
1
1
1111111111111111111111111111111111111



