NO ./assets/textures/wall1dark.xpm
SO ./assets/textures/wall2dark.xpm
WE ./assets/textures/wall3dark.xpm
EA ./assets/textures/wall4dark.xpm

DO ./assets/textures/door.xpm

F ./assets/textures/darkfloor.xpm
C ./assets/textures/black.xpm

        11111111111111111111111111111111
        10000000001100000000000000000001
        1011000001110000000000000011D111
        1001000000D00G000000000000000001
111111111011000001110000000000000000N001
10000000001100000111D1111111111111D11111
100000000000000000011000000000000001
100000000000000000011000000000000001
100000000000000000011000000000000001
111101111111110111000000100000000001
111101111111110111010100100000000001
11110111111111111111D11111D111111111
110000001101010111000000000000000001
1000GG000000000011000000000000000001
1000000G0000G000D0010100000000000001
110000011101010111110111100000000001
11110111 1110101 1011110100000000001
11111111 1111111 1111111111111111111111
