NO ./assets/textures/wall1.xpm
SO ./assets/textures/wall2.xpm
WE ./assets/textures/wall3.xpm
EA ./assets/textures/wall4.xpm

F 71,62,55
C 216,227,231

      111111111111111
      110000000000011
      110000000000011
      110000000000011
      111000000000111
      111W11111111111
      111111111111111
