NO ./assets/textures/wall1dark.xpm
SO ./assets/textures/wall2dark.xpm
WE ./assets/textures/wall3dark.xpm
EA ./assets/textures/wall4dark.xpm

DO ./assets/textures/door.xpm

F ./assets/textures/darkfloor.xpm
C ./assets/textures/starnight.xpm


11111111111111111111111111111111111111111111111111111111111111111111111111111111111111111111111111111111111111111111111111111111111111111111111111111111111
10000000000000000000000000000000000000000000000000000000000000000000000000000000000000000000000000000000000000000000000000000000000000000000000000000001
10111111111111111111111111111111111111111111111111111111111111111111111111111111111111111111111111111111111111111111111111111111111111111111111111111101
10100000000000000000000000000000000000000000000000000000000000000000000000000000000000000000000000000000000000000000000000000000000000000000000000000101
10101111111111111111111111111111111111111111111111111111111111111111111111111111111111111111111111111111111111111111111111111111111111111111111111110101
10101000000000000000000000000000000000000000000000000000000000000000000000000000000000000000000000000000000000000000000000000000000000000000000000010101
10101011111111111111111111111111111111111111111111111111111111111111111111111111111111111111111111111111111111111111111111111111111111111111111110110101
10101010000000000000000000000000000000000000000000000000000000000000000000000000000000000000000000000000000000000000000000000000000000000000000010110101
10101010111111111111111111111111111111111111111111111111111111111111111111111111111111111111111111111111111111111111111111111111111111111111110010110101
10101010100000000000000000000000000000000000000000000000000000000000000000000000000000000000000000000000000000000000000000000000000000000000010010110101
10101010101111111111111111111111111111111111111111111111111111111111111111111111111111111111111111111111111111111111111111111111111111111110010010110101
10101010101000000000000000000000000000000000000000000000000000000000000000000000000000000000000000000000000000000000000000000000000000000010010010110101
10101010101011111111111111111111111111111111111111111111111111111111111111111111111111111111111111111111111111111111111111111111111111110010010010110101
10101010101010000000000000000000000000000000000000000000000000000000000000000000000000000000000000000000000000000000000000000000000000010010010010110101
10101010101010111111111111111111111111111111111111111111111111111111111111111111111111111111111111111111111111111111111111111111111110010010010010110101
10101010101010100000000000000000000000000000000000000000000000000000000000000000000000000000000000000000000000000000000000000000000010010010010010110101
10101010101010101111111111111111111111111111111111111111111111111111111111111111111111111111111111111111111111111111111111111111110010010010010010110101
10101010101010101000000000000000000000000000000000000000000000000000000000000000000000000000000000000000000000000000000000000000010010010010010010110101
10101010101010101011111111111111111111111111111111111111111111111111111111111111111111111111111111111111111111111111111111111110010010010010010010110101
10101010101010101010000000000000000000000000000000000000000000000000000000000000000000000000000000000000000000000000000000000010010010010010010010110101
10101010101010101010111111111111111111111111111111111111111111111111111111111111111111111111111111111111111111111111111111110010010010010010010010110101
10101010101010101010100000000000000000000000000000000000000000000000000000000000000000000000000000000000000000000000000000010010010010010010010010110101
10101010101010101010101111111111111111111111111111111111111111111111111111111111111111111111111111111111111111111111111110010010010010010010010010110101
10101010101010101010101000000000000000000000000000000000000000000000000000000000000000000000000000000000000000000000000010010010010010010010010010110101
10101010101010101010101011111111111111111111111111111111111111111111111111111111111111111111111111111111111111111111110010010010010010010010010010110101
10101010101010101010101010000000000000000000000000000000000000000000000000000000000000000000000000000000000000000000010010010010010010010010010010110101
10101010101010101010101010111111111111111111111111111111111111111111111111111111111111111111111111111111111111111110010010010010010010010010010010110101
10101010101010101010101010100000000000000000000000000000000000000000000000000000000000000000000000000000000000000010010010010010010010010010010010110101
10101010101010101010101010101111111111111111111111111111111111111111111111111111111111111111111111111111111111110010010010010010010010010010010010110101
10101010101010101010101010101000000000000000000000000000000000000000000000000000000000000000000000000000000000010010010010010010010010010010010010110101
10101010101010101010101010101011111111111111111111111111111111111111111111111111111111111111111111111111111110010010010010010010010010010010010010110101
10101010101010101010101010101010000000000000000000000000000000000000000000000000000000000000000000000000000010010010010010010010010010010010010010110101
10101010101010101010101010101010111111111111111111111111111111111111111111111111111111111111111111111111110010010010010010010010010010010010010010110101
10101010101010101010101010101010100000000000000000000000000000000000000000000000000000000000000000000000010010010010010010010010010010010010010010110101
10101010101010101010101010101010101111111111111111111111111111111111111111111111111111111111111111111110010010010010010010010010010010010010010010110101
10101010101010101010101010101010101000000000000000000000000000000000000000000000000000000000000000000010010010010010010010010010010010010010010010110101
10101010101010101010101010101010101011111111111111111111111111111111111111111111111111111111111111110010010010010010010010010010010010010010010010110101
10101010101010101010101010101010101010000000000000000000000000000000000000000000000000000000000000010010010010010010010010010010010010010010010010110101
10101010101010101010101010101010101010111111111111111111111111111111111111111111111111111111111110010010010010010010010010010010010010010010010010110101
10101010101010101010101010101010101010100000000000000000000000000000000000000000000000000000000010010010010010010010010010010010010010010010010010110101
10101010101010101010101010101010101010101111111111111111111111111111111111111111111111111111110010010010010010010010010010010010010010010010010010110101
10101010101010101010101010101010101010101000000000000000000000000000000000000000000000000000010010010010010010010010010010010010010010010010010010110101
10101010101010101010101010101010101010101011111111111111111111111111111111111111111111111110010010010010010010010010010010010010010010010010010010110101
10101010101010101010101010101010101010101010000000000000000000000000000000000000000000000010010010010010010010010010010010010010010010010010010010110101
10101010101010101010101010101010101010101010111111111111111111111111111111111111111111110010010010010010010010010010010010010010010010010010010010110101
10101010101010101010101010101010101010101010100000000000000000000000000000000000000000010010010010010010010010010010010010010010010010010010010010110101
10101010101010101010101010101010101010101010101111111111111111111111111111111111111110010010010010010010010010010010010010010010010010010010010010110101
10101010101010101010101010101010101010101010101000000000000000000000000000000000000010010010010010010010010010010010010010010010010010010010010010110101
10101010101010101010101010101010101010101010101011111111111111111111111111111111110010010010010010010010010010010010010010010010010010010010010010110101
10101010101010101010101010101010101010101010101010000000000000000000000000000000010010010010010010010010010010010010010010010010010010010010010010110101
10101010101010101010101010101010101010101010101010111111111111111111111111111110010010010010010010010010010010010010010010010010010010010010010010110101
10101010101010101010101010101010101010101010101010100000000000000000000000000010010010010010010010010010010010010010010010010010010010010010010010110101
10101010101010101010101010101010101010101010101010101111111111111111111111110010010010010010010010010010010010010010010010010010010010010010010010110101
10101010101010101010101010101010101010101010101010101000000000000000000000010010010010010010010010010010010010010010010010010010010010010010010010110101
10101010101010101010101010101010101010101010101010101011111111111111111110010010010010010010010010010010010010010010010010010010010010010010010010110101
10101010101010101010101010101010101010101010101010101010000000000000000010010010010010010010010010010010010010010010010010010010010010010010010010110101
10101010101010101010101010101010101010101010101010101010111111111111110010010010010010010010010010010010010010010010010010010010010010010010010010110101
10101010101010101010101010101010101010101010101010101010100000000000010010010010010010010010010010010010010010010010010010010010010010010010010010110101
10101010101010101010101010101010101010101010101010101010101111111110010010010010010010010010010010010010010010010010010010010010010010010010010010110101
10101010101010101010101010101010101010101010101010101010101000000010010010010010010010010010010010010010010010010010010010010010010010010010010010110101
10101010101010101010101010101010101010101010101010101010101011110010010010010010010010010010010010010010010010010010010010010010010010010010010010110101
10101010101010101010101010101010101010101010101010101010101010010010010010010010010010010010010010010010010010010010010010010010010010010010010010110101
10101010101010101010101010101010101010101010101010101010101010010010010010010010010010010010010010010010010010010010010010010010010010010010010010110101
10101010101010101010101010101010101010101010101010101010101010010010010010010010010010010010010010010010010010010010010010010010010010010010010010110101
10101010101010101010101010101010101010101010101010101010101010010010010010010010010010010010010010010010010010010010010010010010010010010010010010110101
10101010101010101010101010101010101010101010101010101010101010010010010010010010010010010010010010010010010010010010010010010010010010010010010010110101
10101010101010101010101010101010101010101010101010101010101010010010010010010010010010010010010010010010010010010010010010010010010010010010010010110101
10101010101010101010101010101010101010101010101010101010101010010010010010010010010010010010010010010010010010010010010010010010010010010010010010110101
10101010101010101010101010101010101010101010101010101010101010010010010010010010010010010010010010010010010010010010010010010010010010010010010010110101
10101010101010101010101010101010101010101010101010101010101010010010010010010010010010010010010010010010010010010010010010010010010010010010010010110101
10101010101010101010101010101010101010101010101010101010101010010010010010010010010010010010010010010010010010010010010010010010010010010010010010110101
10101010101010101010101010101010101010101010101010101010101010010010010010010010010010010010010010010010010010010010010010010010010010010010010010110101
10101010101010101010101010101010101010101010101010101010101010010010010010010010010010010010010010010010010010010010010010010010010010010010010010110101
10101010101010101010101010101010101010101010101010101010101010010010010010010010010010010010010010010010010010010010010010010010010010010010010010110101
10101010101010101010101010101010101010101010101010101010101010010010010010010010010010010010010010010010010010010010010010010010010010010010010010110101
10101010101010101010101010101010101010101010101010101010101010010010010010010010010010010010010010010010010010010010010010010010010010010010010010110101
10101010101010101010101010101010101010101010101010101010101010010010010010010010010010010010010010010010010010010010010010010010010010010010010010110101
10101010101010101010101010101010101010101010101010101010101010010010010010010010010010010010010010010010010010010010010010010010010010010010010010110101
10101010101010101010101010101010101010101010101010101010101010010010010010010010010010010010010010010010010010010010010010010010010010010010010010110101
10101010101010101010101010101010101010101010101010101010101010010010010010010010010010010010010010010010010010010010010010010010010010010010010010110101
10101010101010101010101010101010101010101010101010101010101010010010010010010010010010010010010010010010010010010010010010010010010010010010010010110101
10101010101010101010101010101010101010101010101010101010101010010010010010010010010010010010010010010010010010010010010010010010010010010010010010110101
10101010101010101010101010101010101010101010101010101010101010010010010010010010010010010010010010010010010010010010010010010010010010010010010010110101
10101010101010101010101010101010101010101010101010101010101010010010010010010010010010010010010010010010010010010010010010010010010010010010010010110101
10101010101010101010101010101010101010101010101010101010101010010010010010010010010010010010010010010010010010010010010010010010010010010010010010110101
10101010101010101010101010101010101010101010101010101010101010010010010010010010010010010010010010010010010010010010010010010010010010010010010010110101
10101010101010101010101010101010101010101010101010101010101010010010010010010010010010010010010010010010010010010010010010010010010010010010010010110101
10101010101010101010101010101010101010101010101010101010101010010010010010010010010010010010010010010010010010010010010010010010010010010010010010110101
10101010101010101010101010101010101010101010101010101010101010010010010010010010010010010010010010010010010010010010010010010010010010010010010010110101
10101010101010101010101010101010101010101010101010101010101010010010010010010010010010010010010010010010010010010010010010010010010010010010010010110101
10101010101010101010101010101010101010101010101010101010101010010010010010010010010010010010010010010010010010010010010010010010010010010010010010110101
10101010101010101010101010101010101010101010101010101010101010010010010010010010010010010010010010010010010010010010010010010010010010010010010010110101
10101010101010101010101010101010101010101010101010101010101010010010010010010010010010010010010010010010010010010010010010010010010010010010010010110101
10101010101010101010101010101010101010101010101010101010101010010010010010010010010010010010010010010010010010010010010010010010010010010010010010110101
10101010101010101010101010101010101010101010101010101010101010010010010010010010010010010010010010010010010010010010010010010010010010010010010010110101
10101010101010101010101010101010101010101010101010101010101010010010010010010010010010010010010010010010010010010010010010010010010010010010010010110101
10101010101010101010101010101010101010101010101010101010101010010010010010010010010010010010010010010010010010010010010010010010010010010010010010110101
10101010101010101010101010101010101010101010101010101010101010010010010010010010010010010010010010010010010010010010010010010010010010010010010010110101
10101010101010101010101010101010101010101010101010101010101010010010010010010010010010010010010010010010010010010010010010010010010010010010010010110101
10101010101010101010101010101010101010101010101010101010101010010010010010010010010010010010010010010010010010010010010010010010010010010010010010110101
10101010101010101010101010101010101010101010101010101010101010010010010010010010010010010010010010010010010010010010010010010010010010010010010010110101
10101010101010101010101010101010101010101010101010101010101010010010010010010010010010010010010010010010010010010010010010010010010010010010010010110101
10101010101010101010101010101010101010101010101010101010101010010010010010010010010010010010010010010010010010010010010010010010010010010010010010110101
10101010101010101010101010101010101010101010101010101010101010010010010010010010010010010010010010010010010010010010010010010010010010010010010010110101
10101010101010101010101010101010101010101010101010101010101010010010010010010010010010010010010010010010010010010010010010010010010010010010010010110101
10101010101010101010101010101010101010101010101010101010101010010010010010010010010010010010010010010010010010010010010010010010010010010010010010110101
10101010101010101010101010101010101010101010101010101010101010010010010010010010010010010010010010010010010010010010010010010010010010010010010010110101
101010101010101010101010101010101010101010101010101010101010100E0010010010010010010010010010010010010010010010010010010010010010010010010010010010110101
11111111111111111111111111111111111111111111111111111111111111111111111111111111111111111111111111111111111111111111111111111111111111111111111111111111111