NO ./assets/textures/wall1.xpm             
SO ./assets/textures/wall2.xpm
WE ./assets/textures/wall3.xpm
EA ./assets/textures/wall4.xpm 

F 71,62,55
C 216,227,231

        1111111111111111111111111
        10000011 1110000000000001
        10110001 1110000000000001
        10010001 1000000000000001
1111111110110001 111000000001N001
100000000110001 11100011111111111
1111011111110001 100000010001
11110111111111011101010010001
11110111111111011100011111111
11000000110101011100000000001
10000000000000000000000010001
10000000000000000001010010001
11111111111100000011111111001
11111111 1110001111 100000001
11111111 1111111111 111111111
