NO ./assets/textures/wall1.xpm
SO ./assets/textures/wall2.xpm
WE ./assets/textures/wall3.xpm
EA ./assets/textures/wall4.xpm

F 71,62,55
C 216,227,231

        1111111111111111111111111
        1000000000110000000000001
        1011000001110000000000001
        1001000000000000N0000001
111111111011000001110000000000001
100000000011000001110111111111111
11110111111111011100000010001
11110111111111011101010010001
11000000110101011100000010001
10000S00000000001100000010001
10000000000000001101010010001
1100000111010101111101111000111
1111011 1110101 101111010001
11111111 1111111 111111111111

